%%%%%%%%%%%%%%%%%%%%%%
%    %        %#    %
%    %%%%%%%%  %%%%%%
%    %  %#  %        %
%    %%%%%% %%%%%%  %
%          %      % %
%%%%% %%%  %%%%%% % %
    % % %#       % % %
%%%%% % %%%  %%% % %%%%
%            %        %
% %%% %%%  %    %%% %%%
% % %# %#  %%%      %%%
% % % % %%%% %%% %%%%
% %          % %   % %
% %%%%%% %%% % %%% % %
%       %#%  % %#   %
%%%%%%%%%%%%%%%%%%%%%%