%%%%%%%%%%%%%%%%%%%%%%%%%%%%%%
%#     %         %     %   % %
% %%%%% % %% % %%%%%%% % % % %
%   %       % % %      % % % %
% % %%%%%% % % % %%%%%% % % %%
% %       %   %        % %   %
% % %%%% %%%%%%%%%%%%%%%% %%%%
%   %   %     %       % %   %
%%% %%% %%%%% % %%% % %%%%% %%
%   %   %     % %   %   %   %
% %%%%% % %% % %%% %%% % %%%%
% %   % %   % % %   % % %   %
% % %%% % %%% % % % % % %%% %
%   %   %   %   % % % %     %
%%%%% % % % %%%%% % % %%%%%%%
%   % % % % %   % % %       %
% %%% % % % % %%% % % %%% %%%
% %     %   % %   %     % % %
% % %%%%%% % % % %%% %%% % %%
%   %     %   % %   % %   % %
%%% %%% %%% %%% % %%% %%% %%%
%     % %   % %   %   %     %
%%%%%%%% % % % % %%% % %%%%%%
%       % %   % %   %   %   %
% %%%%%%% % %%% %%%%%%% % %%%
%             %     %   %   %
%%%%%%%%%%%%%%%%%%%%%%%%%%%%%%